Below is  result2 

CFXGD	KSSOJ
KUMPN	ADHXE
KSSOJ	EHCHF
EMGNT	DCLSL
DCLSL	LYETM
PFVNH	FSSVX
NJJJK	SDIDY
LYETM	UALBL
EHCHF	WMMMB
WMMMB	WSIQS
SDIDY	IDJRQ
IDJRQ	KCJPN
KCJPN	MDAXY
UALBL	MDAXY
FSSVX	VCPUC
MDAXY	WSIQS
VCPUC	GJAFJ
GJAFJ	UALBL
WSIQS	WSIQS
ADHXE	GJAFJ
